..#####
..#...#####
.##.......#
##........#
#.......@.#
##........#
!#........#
.#.......##
.#......##
.......##
.#######
