...###
..##.#.####
.##..###..#
##........#
#...@..#..#
###..###..#
.!#..#....#
.##.##.#.##
.#......##
.......##
..#######