....##....
..#..#.###
.##..###..
#..#.#.#..
####.###..
..#..#....
.##.##...#
........##
#......###
@..###..##